16 16
0 0
2 1 1 2 1 1 2 1 1 2 1 1 2 1 1 2
4 4 4 4 0 0 0 0 0 6 0 0 0 0 0 0
0 4 4 4 0 0 0 0 0 6 0 0 0 0 0 0
0 0 4 4 0 0 0 0 0 6 0 0 0 0 0 0
2 0 0 4 0 0 0 0 0 6 0 0 0 0 0 2
1 0 0 4 4 0 5 6 6 6 0 0 0 0 0 1
2 0 0 4 0 0 5 6 0 0 0 0 0 0 0 1
1 0 0 0 5 5 5 6 0 0 0 0 0 0 0 2
1 0 0 0 5 6 6 6 6 6 0 0 0 0 0 1
2 0 0 0 5 6 6 6 6 6 0 0 0 0 0 1
1 0 0 0 0 6 6 6 6 0 0 0 0 0 0 2
1 0 0 0 0 0 0 6 0 0 0 0 0 0 0 1
2 0 0 0 0 0 0 0 0 0 0 0 0 0 0 1
1 0 0 0 0 0 0 0 0 0 0 0 0 0 0 2
1 0 0 0 0 0 0 0 0 0 0 0 0 0 0 1
2 1 2 1 1 1 2 1 1 1 1 2 1 1 2 1